11111111111111111111
1P000000010000000001
10100000010000000001
11111111010000000001
10000000000000000001
11111111001011111101
10000000001000000001
10000000001000000001
11111111111111111111
